[
	{
		"name": "Empty",
		"background_tilemap": [
			"~~~~~~~~~~~~~~~~~~~~~~~~~",
			"~~~~~~~~~~~~~~~~~~~~~~~~~",
			"~~~~~~~~~~~~~~~~~~~~~~~~~",
			"~~~~~~~~~~~~~~~~~~~~~~~~~",
			"~~~~~~~~~~~~~~~~~~~~~~~~~",
			"~~~~~~~~~~~~~~~~~~~~~~~~~",
			"~~~~~~~~~~~~~~~~~~~~~~~~~",
			"~~~~~~~~~~~~~~~~~~~~~~~~~",
			"~~~~~~~~~~~~~~~~~~~~~~~~~",
			"~~~~~~~~~~~~~~~~~~~~~~~~~",
			"~~~~~~~~~~~~~~~~~~~~~~~~~",
			"~~~~~~~~~~~~~~~~~~~~~~~~~",
			"~~~~~~~~~~~~~~~~~~~~~~~~~",
			"~~~~~~~~~~~~~~~~~~~~~~~~~",
			"~~~~~~~~~~~~~~~~~~~~~~~~~",
			"~~~~~~~~~~~~~~~~~~~~~~~~~",
			"~~~~~~~~~~~~~~~~~~~~~~~~~",
			"~~~~~~~~~~~~~~~~~~~~~~~~~",
			"~~~~~~~~~~~~~~~~~~~~~~~~~"
		],
		"obj_tilemap":[
			"~~~~~~~~~~~~~~~~~~~~~~~~~",
			"~~~~~~~~~~~~~~~~~~~~~~~~~",
			"~~~~~~~~~~~~~~~~~~~~~~~~~",
			"~~~~~~~~~~~~~~~~~~~~~~~~~",
			"~~~~~~~~~~~~~~~~~~~~~~~~~",
			"~~~~~~~~~~~~~~~~~~~~~~~~~",
			"~~~~~~~~~~~~~~~~~~~~~~~~~",
			"~~~~~~~~~~~~~~~~~~~~~~~~~",
			"~~~~~~~~~~~~~~~~~~~~~~~~~",
			"~~~~~~~~~~~~~~~~~~~~~~~~~",
			"~~~~~~~~~~~~~~~~~~~~~~~~~",
			"~~~~~~~~~~~~~~~~~~~~~~~~~",
			"~~~~~~~~~~~~~~~~~~~~~~~~~",
			"~~~~~~~~~~~~~~~~~~~~~~~~~",
			"~~~~~~~~~~~~~~~~~~~~~~~~~",
			"~~~~~~~~~~~~~~~~~~~~~~~~~",
			"~~~~~~~~~~~~~~~~~~~~~~~~~",
			"~~~~~~~~~~~~~~~~~~~~~~~~~",
			"~~~~~~~~~~~~~~~~~~~~~~~~~"
		]
	},
	{
		"name": "Room",
		"background_tilemap": [
			"ggggggggggggggggggggggggg",
			"wwwwwwwwwwwwwwwwwwwwwwwww",
			"wwwwwwwwwwwwwwwwwwwwwwwww",
			"wwwwwwwwwwwwwwwwwwwwwwwww",
			"wwwwwwwwwwwwwwwwwwwwwwwww",
			"wwwwwwwwwwwwwwwwwwwwwwwww",
			"wwwwwwwwwwwwwwwwwwwwwwwww",
			"wwwwwwwwwwwwwwwwwwwwwwwww",
			"wwwwwwwwwwwwwwwwwwwwwwwww",
			"wwwwwwwwwwwwwwwwwwwwwwwww",
			"wwwwwwwwwwwwwwwwwwwwwwwww",
			"wwwwwwwwwwwwwwwwwwwwwwwww",
			"wwwwwwwwwwwwwwwwwwwwwwwww",
			"wwwwwwwwwwwwwwwwwwwwwwwww",
			"wwwwwwwwwwwwwwwwwwwwwwwww",
			"wwwwwwwwwwwwwwwwwwwwwwwww",
			"wwwwwwwwwwwwwwwwwwwwwwwww",
			"wwwwwwwwwwwwwwwwwwwwwwwww",
			"ggggggggggggggggggggggggg"
		],
		"obj_tilemap":[
			"~~~~~~~~~~~~~~~~~~~~~~~~~",
			"f~ff~fff~ffff~fffff~ffff~",
			"f~ffffffffffffffffffffff~",
			"f~~~~~~~~~~~~~~~~~~~~~~~~",
			"f~~f~~~~~~~~~~~~~~~~~f~~f",
			"~~~f~~~~~~~~~~~~~~~~~f~~~",
			"~~~f~~~~~~~~~~~~~~~~~ff~f",
			"~~~f~~~~~~~~~~~~~~~~~f~f~",
			"~~~f~~~~~~~~~~~~~~~~~f~~f",
			"~~~f~~~~~~~~~~~~~~~~~~~~~",
			"~~~f~~~~~~~~~~~~~~~~~~~~f",
			"~~~f~~~~fff~~~~~~~~~~f~~~",
			"~~~~~~~~~~~~~~~~~f~~~~~~~",
			"~~~~~~~~~~~~~~~~f~~~~p~~~",
			"~~~~~~~~~~~~~~~f~~~~~~~~~",
			"~~~~~~ff~~~~~f~~~~~~~~~~~",
			"~~~~~f~~~~~~~~~~~l~c~t~~~",
			"fffffffffffffffffffffffff",
			"~~~~~~~~~~~~~~~~~~~~~~~~~"
		]
	}
]