[
	{
		"name": "Empty",
		"background_tilemap": [
			"~~~~~~~~~~~~~~~~~~~~~~~~~",
			"~~~~~~~~~~~~~~~~~~~~~~~~~",
			"~~~~~~~~~~~~~~~~~~~~~~~~~",
			"~~~~~~~~~~~~~~~~~~~~~~~~~",
			"~~~~~~~~~~~~~~~~~~~~~~~~~",
			"~~~~~~~~~~~~~~~~~~~~~~~~~",
			"~~~~~~~~~~~~~~~~~~~~~~~~~",
			"~~~~~~~~~~~~~~~~~~~~~~~~~",
			"~~~~~~~~~~~~~~~~~~~~~~~~~",
			"~~~~~~~~~~~~~~~~~~~~~~~~~",
			"~~~~~~~~~~~~~~~~~~~~~~~~~",
			"~~~~~~~~~~~~~~~~~~~~~~~~~",
			"~~~~~~~~~~~~~~~~~~~~~~~~~",
			"~~~~~~~~~~~~~~~~~~~~~~~~~",
			"~~~~~~~~~~~~~~~~~~~~~~~~~",
			"~~~~~~~~~~~~~~~~~~~~~~~~~",
			"~~~~~~~~~~~~~~~~~~~~~~~~~",
			"~~~~~~~~~~~~~~~~~~~~~~~~~",
			"~~~~~~~~~~~~~~~~~~~~~~~~~"
		],
		"obj_tilemap:":[
			"~~~~~~~~~~~~~~~~~~~~~~~~~",
			"~~~~~~~~~~~~~~~~~~~~~~~~~",
			"~~~~~~~~~~~~~~~~~~~~~~~~~",
			"~~~~~~~~~~~~~~~~~~~~~~~~~",
			"~~~~~~~~~~~~~~~~~~~~~~~~~",
			"~~~~~~~~~~~~~~~~~~~~~~~~~",
			"~~~~~~~~~~~~~~~~~~~~~~~~~",
			"~~~~~~~~~~~~~~~~~~~~~~~~~",
			"~~~~~~~~~~~~~~~~~~~~~~~~~",
			"~~~~~~~~~~~~~~~~~~~~~~~~~",
			"~~~~~~~~~~~~~~~~~~~~~~~~~",
			"~~~~~~~~~~~~~~~~~~~~~~~~~",
			"~~~~~~~~~~~~~~~~~~~~~~~~~",
			"~~~~~~~~~~~~~~~~~~~~~~~~~",
			"~~~~~~~~~~~~~~~~~~~~~~~~~",
			"~~~~~~~~~~~~~~~~~~~~~~~~~",
			"~~~~~~~~~~~~~~~~~~~~~~~~~",
			"~~~~~~~~~~~~~~~~~~~~~~~~~",
			"~~~~~~~~~~~~~~~~~~~~~~~~~"
		]
	},
	{
		"name": "Room",
		"background_tilemap": [
			"wwwwwwwwwwwwwwwwwwwwwwwww",
			"wwwwwwwwwwwwwwwwwwwwwwwww",
			"wwwwwwwwwwwwwwwwwwwwwwwww",
			"wwwwwwwwwwwwwwwwwwwwwwwww",
			"wwwwwwwwwwwwwwwwwwwwwwwww",
			"wwwwwwwwwwwwwwwwwwwwwwwww",
			"wwwwwwwwwwwwwwwwwwwwwwwww",
			"wwwwwwwwwwwwwwwwwwwwwwwww",
			"wwwwwwwwwwwwwwwwwwwwwwwww",
			"wwwwwwwwwwwwwwwwwwwwwwwww",
			"wwwwwwwwwwwwwwwwwwwwwwwww",
			"wwwwwwwwwwwwwwwwwwwwwwwww",
			"wwwwwwwwwwwwwwwwwwwwwwwww",
			"wwwwwwwwwwwwwwwwwwwwwwwww",
			"wwwwwwwwwwwwwwwwwwwwwwwww",
			"wwwwwwwwwwwwwwwwwwwwwwwww",
			"wwwwwwwwwwwwwwwwwwwwwwwww",
			"wwwwwwwwwwwwwwwwwwwwwwwww",
			"wwwwwwwwwwwwwwwwwwwwwwwww"
		],
		"obj_tilemap:":[
			"ggggggggggggggggggggggggg",
			"~~~~~~~~~~~~~~~~~~~~~~~~~",
			"~~~~~~~~~~~~~~~~~~~~~~~~~",
			"~~~~~~~~~~~~~~~~~~~~~~~~~",
			"~~~f~~~~~~~~~~~~~~~~~~~~~",
			"~~~f~~~~~~fff~~~~~~~~~~~~",
			"~~~f~~~~~~~~~~~f~~~~~~~~~",
			"~~~f~~~~~~~~~~~~~~f~~~~~~",
			"~~~f~~~~~~~~~f~~~~~~f~~~~",
			"~~~f~~~~~~~~~f~~~~~~~f~~~",
			"~~~f~~~~~~~~fff~~~~~~~~~~",
			"~~~f~~~~~~~~~f~~~~~~~~~f~",
			"~~~~~~~~~ff~~f~~~~~~~~f~~",
			"~~~~~~~~f~~~~~~~~~~~~f~~~",
			"~f~~~~~ff~~~~~~~~p~~f~~~~",
			"~~~~~ff~f~~~~~~~~~~f~~~~~",
			"~~~~~~~~f~~~~lct~~f~~~~~~",
			"fffffffffffffffffffffffff",
			"ggggggggggggggggggggggggg"
		]
	}
]